***************
* *   *       *
* * * * * *****
* @ *   * *   *
******* *** * *
*           * *
******* *******
*         *   *
*** *** * * ***
* *   * *     *
* ***** ***** *
*       * *   *
********* * ***
*             *
*************!*